1111111111111111
0000000110000000
0110011111110010
0000010000010010
0000010000011110
0000010011000000
1111110000001000
0111000000000000
0000000000000011