1111111111111111
0110001111000110
0111111001111110
0100001000000010
0100001001000010
0110001001010010
0100001001000010
0111111001111110
0000000111000000