1111111111111111
0000000000000000
0011000001000000
0011000001000000
1011000000000000
1011111111111101
0011111111111101
0000000000000000
0000000000000000