1111111111111111
1100000100000010
0001111111110010
0001111000010010
0001000111110010
0001000100000010
0001010111100010
1001000111111110
0000000000000100