1111111111111111
0000000110000000
0111111000000010
0000001000000010
0000001000000010
0000001000000010
1000001000001010
0011001111111110
0000000000000011