1111111111111111
0101100111111011
0000000100001000
0111111100101000
0000000000001000
0111111100001000
0000000100001000
0111100111111010
0000000000000000