1111111111111111
0111111011111110
0100001110000010
0111110001111110
0000010001000000
0000010101000000
0000010001000000
0100011111001111
0000000000010000