1111111111111111
0001111101111100
0001000000000110
0001111101111110
0100000101000000
0100000111000000
0000000111000000
0000000101000000
0000000111000000