1111111111111111
0000000000000000
1111000000001111
1001001000001001
1001001000001001
1001000000001101
1001000000001101
1101111111111001
0100000000000000