1111111111111111
1000000000000000
1111111111011110
0100000001010000
0100100101011110
0100100101001010
0100000101001010
0111111101111110
0000000000000000