1111111111111111
0000000110001000
1111000000000011
0001000000000000
0001000110011100
0001000000010100
1001000000011111
0001111111110000
1100000000000011