1111111111111111
0000110000011000
0000001000111100
0111111111100100
0100001000000110
0111111111100100
0000000000111100
0000000000000000
0000000010000000