1111111111111111
0001111000000000
0001000000001000
0001000100001000
0001001111011000
0001101001001000
0001001001001000
0101111001111100
0000000000000011