1111111111111111
0100000001101100
0111111111111010
0100000000001010
0100111111111010
0100000010000010
0111111111111110
0000000000000010
0100000011100000