1111111111111111
0100110111111100
0100000100000100
0100111100110100
0100000100000100
0100100100100100
0100000100000100
0111111101111100
1000000010000000