1111111111111111
0000110000001000
0011111111111100
0010000000110100
0011011101110100
0010010101110100
0010010111011100
0100000000000000
0000000000000000