1111111111111111
0000111100000000
0000001000000000
0111111111111110
0000000100001010
1111111111111110
0000000000000000
0000000000111100
0000000000000000