1111111111111111
0000000000011100
0001101111000000
0000001001000000
0111101101011110
0100111001000010
0100001001000010
0111111001111110
0000000110000000