1111111111111111
0000000110000000
0000000000000000
1111110000111111
0000010000100000
0000011111100000
1000000000001000
0011000000000000
0000000000000011