1111111111111111
0111100000000000
0000100000000100
0000111100000100
0000000100000000
0000000111100000
0010000000100000
0010000000111100
0000000000000000