1111111111111111
0111100000000111
0010001000000100
0010000000100100
0010000100000100
0010000000000100
0010000000000100
0011111111111100
1100000000001000