1111111111111111
0000000000000000
0111111111111110
0100000000000010
0101111001111010
0101001001001010
0101001001001010
0111001111001110
0000000000000000