1111111111111111
0000110000000011
0011111111111100
0010000000110100
0010000100000100
0010100000100100
0010000000000100
0111111111111100
0000001100000000