1111111111111111
0111111111111110
0000000000000010
0111111111111010
0100110000001010
0101111111111010
0100000000000010
0111111111111110
1100000000000000