1111111111111111
0000000000000000
0011111111111100
0011000000000010
0011111111111110
0010000000000100
0111111111111100
0100000000000000
0000000000000000