1111111111111111
0000001000000000
0111100011111110
0000100010111110
0010100011000010
0000111110111110
0000000000000000
0000010000000000
0000000000000000