1111111111111111
0000111100000010
0000000001000010
0000000000000010
0101111111110010
0101100000110010
0101000000010010
0111000000011110
1000000010000000