1111111111111111
0011111011111100
0010001011000100
0010001001000100
0010001111000100
0010100000000100
0010100000000100
0011111111111101
0000000000000001