1111111111111111
0111111110001111
0000000010000000
0100100010000000
0000100011111110
0000100010000100
0000100000000100
1000111111111100
1110000000000000