1111111111111111
0000000000010000
0011111111111100
0110000011110100
0011111100000100
0011111110000100
0010100000000100
0011111111111100
0000000000000010