1111111111111111
0000111111101000
0000100000111000
0100101000111000
0100101000101000
0000111111101000
0000110000001000
0000111111111000
0000000000000000