1111111111111111
0100000000000000
0100000001111110
0100000001000110
0111111111000110
0100010000000010
0100010000000010
1111111111111110
1000000000000000