1111111111111111
0111100010010000
0001000010010000
0000000010010000
0001111110010010
0001000000010000
0001000011110000
1001111111110000
0000000000000100