1111111111111111
0111111111111111
0101001000000001
0001001000010000
1101001000000000
0001001111111110
1111000010000010
0001111111111110
0000000000000000