1111111111111111
0000000000000000
0000110011111100
0000000010000100
0100011110110100
0000010000000100
0011110001000100
0011000000000100
0000000000001000