1111111111111111
0000000000000010
0101111111111000
0001000000001000
0001001100001001
0001000000001000
1001000011001000
0001000000001000
0001000000001011