1111111111111111
1100100000000011
0000000000000000
0111111111111110
0100000000000010
1100000000000011
0000000000000000
0010000011001000
0000010000000000