1111111111111111
0111100111111110
0000100100000000
0011100100000000
0000000100001000
0000000100100000
0000000100000000
1111111100000111
0000000000000000