1111111111111111
0000000000000000
0111111000010000
0000001000010000
0001001000000000
0001101111111110
0001100000000010
1001111111111110
1000000000000000