1111111111111111
0000000000000000
0111111100000000
0000000100000000
0000000100000000
0000000100000000
0000000100000000
0000000111111110
0000000000000000