1111111111111111
0111100000000000
0011111011111100
0010001110000100
0010111010000110
0010100001000100
0011111111111100
0000000000000000
0000011110000100